################
#     G@G      #
#     G G      #
#    GGGG      #
#      X       #
#              #
#  oooooooooooo#
#  ddd    d  d #
#  dddd d      #
#              #
#    G d       #
#          d   #
#              #
#              #
#              #
################
