################
#      @       #
#              #
#              #
#      X       #
#              #
#              #
#          s   #
#              #
#              #
#    c         #
#          G   #
#              #
#              #
#              #
################
